,date,full_tax_count,chocolate_count,difference,moving_average_3
0,01/01/2020,49,3,46,
1,02/01/2020,21,49,-28,
2,03/01/2020,8,27,-19,
3,04/01/2020,13,62,-49,
4,05/01/2020,112,0,112,12.4
5,06/01/2020,219,9,210,45.2
6,07/01/2020,11,1,10,52.8
7,08/01/2020,18,0,18,60.2
8,09/01/2020,42,27,15,73
9,10/01/2020,44,4,40,58.6
10,11/01/2020,15,45,-30,10.6
11,12/01/2020,4,13,-9,6.8
12,13/01/2020,12,2,10,5.2
13,14/01/2020,11,2,9,4
14,15/01/2020,12,2,10,-2
15,16/01/2020,13,0,13,6.6
16,17/01/2020,10,2,8,10
17,18/01/2020,12,2,10,10
18,19/01/2020,13,4,9,10
19,20/01/2020,13,2,11,10.2
20,21/01/2020,11,1,10,9.6
21,22/01/2020,11,0,11,10.2
22,23/01/2020,12,0,12,10.6
23,24/01/2020,10,0,10,10.8
24,25/01/2020,11,0,11,10.8
25,26/01/2020,11,0,11,11
26,27/01/2020,13,2,11,11
27,28/01/2020,10,1,9,10.4
28,29/01/2020,11,32,-21,4.2
29,30/01/2020,13,76,-63,-10.6
30,31/01/2020,12,66,-54,-23.6
31,01/02/2020,23,1,22,-21.4
32,02/02/2020,62,55,7,-21.8
33,03/02/2020,12,25,-13,-20.2
34,04/02/2020,41,50,-9,-9.4
35,05/02/2020,110,0,110,23.4
36,06/02/2020,317,10,307,80.4
37,07/02/2020,2,1,1,79.2
38,08/02/2020,13,2,11,84
39,09/02/2020,61,51,10,87.8
40,10/02/2020,34,0,34,72.6
41,11/02/2020,12,45,-33,4.6
42,12/02/2020,18,14,4,5.2
43,13/02/2020,23,2,21,7.2
44,14/02/2020,10,0,10,7.2
45,15/02/2020,4,0,4,1.2
46,16/02/2020,15,0,15,10.8
47,17/02/2020,30,3,27,15.4
48,18/02/2020,12,2,10,13.2
49,19/02/2020,21,2,19,15
50,20/02/2020,10,3,7,15.6
51,21/02/2020,5,2,3,13.2
52,22/02/2020,3,0,3,8.4
53,23/02/2020,6,2,4,7.2
54,24/02/2020,5,1,4,4.2
55,25/02/2020,4,16,-12,0.4
56,26/02/2020,7,18,-11,-2.4
57,27/02/2020,10,36,-26,-8.2
58,28/02/2020,7,8,-1,-9.2
59,29/02/2020,3,1,2,-9.6
60,01/03/2020,10,0,10,-5.2
61,02/03/2020,70,48,22,1.4
62,03/03/2020,37,39,-2,6.2
63,04/03/2020,77,8,69,20.2
64,05/03/2020,107,0,107,41.2
65,06/03/2020,371,14,357,110.6
66,07/03/2020,2,3,-1,106
67,08/03/2020,0,0,0,106.4
68,09/03/2020,52,89,-37,85.2
69,10/03/2020,18,0,18,67.4
70,11/03/2020,10,27,-17,-7.4
71,12/03/2020,38,13,25,-2.2
72,13/03/2020,26,3,23,2.4
73,14/03/2020,6,2,4,10.6
74,15/03/2020,28,0,28,12.6
75,16/03/2020,29,0,29,21.8
76,17/03/2020,29,0,29,22.6
77,18/03/2020,29,0,29,23.8
78,19/03/2020,28,4,24,27.8
79,20/03/2020,2,0,2,22.6
80,21/03/2020,3,0,3,17.4
81,22/03/2020,1,19,-18,8
82,23/03/2020,2,36,-34,-4.6
83,24/03/2020,2,42,-40,-17.4
84,25/03/2020,2,66,-64,-30.6
85,26/03/2020,2,72,-70,-45.2
86,27/03/2020,2,46,-44,-50.4
87,28/03/2020,3,34,-31,-49.8
88,29/03/2020,2,69,-67,-55.2
89,30/03/2020,1,68,-67,-55.8
90,31/03/2020,1,70,-69,-55.6
91,01/04/2020,11,1,10,-44.8
92,02/04/2020,79,44,35,-31.6
93,03/04/2020,68,28,40,-10.2
94,04/04/2020,80,5,75,18.2
95,05/04/2020,96,0,96,51.2
96,06/04/2020,305,20,285,106.2
97,07/04/2020,4,2,2,99.6
98,08/04/2020,4,0,4,92.4
99,09/04/2020,52,0,52,87.8
100,10/04/2020,12,0,12,71
101,11/04/2020,17,29,-12,11.6
102,12/04/2020,46,5,41,19.4
103,13/04/2020,68,36,32,25
104,14/04/2020,67,25,42,23
105,15/04/2020,6,21,-15,17.6
106,16/04/2020,2,14,-12,17.6
107,17/04/2020,39,12,27,14.8
108,18/04/2020,36,6,30,14.4
109,19/04/2020,36,10,26,11.2
110,20/04/2020,37,6,31,20.4
111,21/04/2020,1,1,0,22.8
112,22/04/2020,38,8,30,23.4
113,23/04/2020,39,1,38,25
114,24/04/2020,99,1,98,39.4
115,25/04/2020,128,0,128,58.8
116,26/04/2020,117,2,115,81.8
117,27/04/2020,98,1,97,95.2
118,28/04/2020,73,1,72,102
119,29/04/2020,141,0,141,110.6
120,30/04/2020,126,1,125,110
121,01/05/2020,12,2,10,89
122,02/05/2020,54,40,14,72.4
123,03/05/2020,61,23,38,65.6
124,04/05/2020,52,41,11,39.6
125,05/05/2020,104,0,104,35.4
126,06/05/2020,131,34,97,52.8
127,07/05/2020,5,0,5,51
128,08/05/2020,0,1,-1,43.2
129,09/05/2020,35,0,35,48
130,10/05/2020,21,0,21,31.4
131,11/05/2020,10,22,-12,9.6
132,12/05/2020,47,4,43,17.2
133,13/05/2020,93,0,93,36
134,14/05/2020,95,0,95,48
135,15/05/2020,77,0,77,59.2
136,16/05/2020,59,0,59,73.4
137,17/05/2020,59,2,57,76.2
138,18/05/2020,59,37,22,62
139,19/05/2020,57,41,16,46.2
140,20/05/2020,58,36,22,35.2
141,21/05/2020,55,30,25,28.4
142,22/05/2020,90,36,54,27.8
143,23/05/2020,61,32,29,29.2
144,24/05/2020,79,34,45,35
145,25/05/2020,24,34,-10,28.6
146,26/05/2020,22,29,-7,22.2
147,27/05/2020,92,10,82,27.8
148,28/05/2020,120,10,110,44
149,29/05/2020,109,11,98,54.6
150,30/05/2020,103,10,93,75.2
151,31/05/2020,186,11,175,111.6
152,01/06/2020,11,0,11,97.4
153,02/06/2020,74,28,46,84.6
154,03/06/2020,93,3,90,83
155,04/06/2020,70,35,35,71.4
156,05/06/2020,116,1,115,59.4
157,06/06/2020,47,33,14,60
158,07/06/2020,3,0,3,51.4
159,08/06/2020,4,0,4,34.2
160,09/06/2020,61,1,60,39.2
161,10/06/2020,38,0,38,23.8
162,11/06/2020,2,25,-23,16.4
163,12/06/2020,84,4,80,31.8
164,13/06/2020,45,28,17,34.4
165,14/06/2020,48,30,18,26
166,15/06/2020,47,22,25,23.4
167,16/06/2020,39,11,28,33.6
168,17/06/2020,21,6,15,20.6
169,18/06/2020,33,2,31,23.4
170,19/06/2020,18,0,18,23.4
171,20/06/2020,20,0,20,22.4
172,21/06/2020,19,1,18,20.4
173,22/06/2020,27,0,27,22.8
174,23/06/2020,16,0,16,19.8
175,24/06/2020,13,1,12,18.6
176,25/06/2020,25,3,22,19
177,26/06/2020,22,2,20,19.4
178,27/06/2020,18,1,17,17.4
179,28/06/2020,30,1,29,20
180,29/06/2020,32,1,31,23.8
181,30/06/2020,30,1,29,25.2
182,01/07/2020,11,1,10,23.2
183,02/07/2020,54,29,25,24.8
184,03/07/2020,46,2,44,27.8
185,04/07/2020,53,27,26,26.8
186,05/07/2020,98,0,98,40.6
187,06/07/2020,64,20,44,47.4
188,07/07/2020,2,1,1,42.6
189,08/07/2020,3,0,3,34.4
190,09/07/2020,59,0,59,41
191,10/07/2020,41,0,41,29.6
192,11/07/2020,7,22,-15,17.8
193,12/07/2020,52,0,52,28
194,13/07/2020,39,54,-15,24.4
195,14/07/2020,48,51,-3,12
196,15/07/2020,45,61,-16,0.6
197,16/07/2020,43,74,-31,-2.6
198,17/07/2020,35,75,-40,-21
199,18/07/2020,38,70,-32,-24.4
200,19/07/2020,28,64,-36,-31
201,20/07/2020,13,48,-35,-34.8
202,21/07/2020,18,33,-15,-31.6
203,22/07/2020,11,51,-40,-31.6
204,23/07/2020,26,45,-19,-29
205,24/07/2020,39,2,37,-14.4
206,25/07/2020,38,5,33,-0.8
207,26/07/2020,46,2,44,11
208,27/07/2020,13,14,-1,18.8
209,28/07/2020,16,16,0,22.6
210,29/07/2020,13,15,-2,14.8
211,30/07/2020,11,9,2,8.6
212,31/07/2020,16,1,15,2.8
213,01/08/2020,11,0,11,5.2
214,02/08/2020,48,37,11,7.4
215,03/08/2020,102,3,99,27.6
216,04/08/2020,127,27,100,47.2
217,05/08/2020,93,0,93,62.8
218,06/08/2020,46,22,24,65.4
219,07/08/2020,5,1,4,64
220,08/08/2020,2,9,-7,42.8
221,09/08/2020,102,0,102,43.2
222,10/08/2020,17,0,17,28
223,11/08/2020,11,9,2,23.6
224,12/08/2020,58,9,49,32.6
225,13/08/2020,50,19,31,40.2
226,14/08/2020,52,10,42,28.2
227,15/08/2020,30,5,25,29.8
228,16/08/2020,51,16,35,36.4
229,17/08/2020,60,14,46,35.8
230,18/08/2020,62,10,52,40
231,19/08/2020,58,5,53,42.2
232,20/08/2020,58,4,54,48
233,21/08/2020,50,0,50,51
234,22/08/2020,68,0,68,55.4
235,23/08/2020,8,0,8,46.6
236,24/08/2020,5,1,4,36.8
237,25/08/2020,7,1,6,27.2
238,26/08/2020,3,22,-19,13.4
239,27/08/2020,3,55,-52,-10.6
240,28/08/2020,3,24,-21,-16.4
241,29/08/2020,4,11,-7,-18.6
242,30/08/2020,5,14,-9,-21.6
243,31/08/2020,5,14,-9,-19.6
244,01/09/2020,13,2,11,-7
245,02/09/2020,58,38,20,1.2
246,03/09/2020,145,3,142,31
247,04/09/2020,122,12,110,54.8
248,05/09/2020,91,0,91,74.8
249,06/09/2020,49,20,29,78.4
250,07/09/2020,1,3,-2,74
251,08/09/2020,1,16,-15,42.6
252,09/09/2020,100,0,100,40.6
253,10/09/2020,32,0,32,28.8
254,11/09/2020,10,7,3,23.6
255,12/09/2020,59,66,-7,22.6
256,13/09/2020,46,2,44,34.4
257,14/09/2020,49,0,49,24.2
258,15/09/2020,50,0,50,27.8
259,16/09/2020,26,0,26,32.4
260,17/09/2020,26,1,25,38.8
261,18/09/2020,24,1,23,34.6
262,19/09/2020,10,0,10,26.8
263,20/09/2020,18,1,17,20.2
264,21/09/2020,27,0,27,20.4
265,22/09/2020,37,0,37,22.8
266,23/09/2020,44,2,42,26.6
267,24/09/2020,53,0,53,35.2
268,25/09/2020,52,0,52,42.2
269,26/09/2020,32,0,32,43.2
270,27/09/2020,32,0,32,42.2
271,28/09/2020,19,0,19,37.6
272,29/09/2020,49,0,49,36.8
273,30/09/2020,45,0,45,35.4
274,01/10/2020,10,2,8,30.6
275,02/10/2020,25,47,-22,19.8
276,03/10/2020,133,4,129,41.8
277,04/10/2020,126,12,114,54.8
278,05/10/2020,95,0,95,64.8
279,06/10/2020,50,27,23,67.8
280,07/10/2020,3,9,-6,71
281,08/10/2020,27,18,9,47
282,09/10/2020,63,3,60,36.2
283,10/10/2020,22,0,22,21.6
284,11/10/2020,3,11,-8,15.4
285,12/10/2020,63,73,-10,14.6
286,13/10/2020,19,0,19,16.6
287,14/10/2020,24,0,24,9.4
288,15/10/2020,14,0,14,7.8
289,16/10/2020,15,0,15,12.4
290,17/10/2020,18,0,18,18
291,18/10/2020,26,0,26,19.4
292,19/10/2020,20,0,20,18.6
293,20/10/2020,27,0,27,21.2
294,21/10/2020,23,0,23,22.8
295,22/10/2020,15,24,-9,17.4
296,23/10/2020,5,38,-33,5.6
297,24/10/2020,11,31,-20,-2.4
298,25/10/2020,19,35,-16,-11
299,26/10/2020,12,38,-26,-20.8
300,27/10/2020,15,13,2,-18.6
301,28/10/2020,17,35,-18,-15.6
302,29/10/2020,10,43,-33,-18.2
303,30/10/2020,7,36,-29,-20.8
304,31/10/2020,11,39,-28,-21.2
305,01/11/2020,11,1,10,-19.6
306,02/11/2020,19,40,-21,-20.2
307,03/11/2020,124,3,121,10.6
308,04/11/2020,108,15,93,35
309,05/11/2020,104,0,104,61.4
310,06/11/2020,54,35,19,63.2
311,07/11/2020,18,10,8,69
312,08/11/2020,51,20,31,51
313,09/11/2020,66,1,65,45.4
314,10/11/2020,15,0,15,27.6
315,11/11/2020,5,25,-20,19.8
316,12/11/2020,46,88,-42,9.8
317,13/11/2020,12,6,6,4.8
318,14/11/2020,7,28,-21,-12.4
319,15/11/2020,6,29,-23,-20
320,16/11/2020,7,27,-20,-20
321,17/11/2020,5,26,-21,-15.8
322,18/11/2020,7,34,-27,-22.4
323,19/11/2020,6,34,-28,-23.8
324,20/11/2020,2,21,-19,-23
325,21/11/2020,5,35,-30,-25
326,22/11/2020,3,32,-29,-26.6
327,23/11/2020,4,15,-11,-23.4
328,24/11/2020,4,16,-12,-20.2
329,25/11/2020,9,16,-7,-17.8
330,26/11/2020,4,27,-23,-16.4
331,27/11/2020,6,20,-14,-13.4
332,28/11/2020,5,22,-17,-14.6
333,29/11/2020,5,15,-10,-14.2
334,30/11/2020,1,15,-14,-15.6
335,01/12/2020,11,0,11,-8.8
336,02/12/2020,20,18,2,-5.6
337,03/12/2020,159,2,157,29.2
338,04/12/2020,86,33,53,41.8
339,05/12/2020,99,0,99,64.4
340,06/12/2020,43,27,16,65.4
341,07/12/2020,41,43,-2,64.6
342,08/12/2020,45,14,31,39.4
343,09/12/2020,66,0,66,42
344,10/12/2020,13,0,13,24.8
345,11/12/2020,17,11,6,22.8
346,12/12/2020,48,74,-26,18
347,13/12/2020,80,91,-11,9.6
348,14/12/2020,30,89,-59,-15.4
349,15/12/2020,36,62,-26,-23.2
350,16/12/2020,33,85,-52,-34.8
351,17/12/2020,20,49,-29,-35.4
352,18/12/2020,8,16,-8,-34.8
353,19/12/2020,12,17,-5,-24
354,20/12/2020,134,20,114,4
355,21/12/2020,147,30,117,37.8
356,22/12/2020,254,20,234,90.4
357,23/12/2020,235,9,226,137.2
358,24/12/2020,122,4,118,161.8
359,25/12/2020,132,6,126,164.2
360,26/12/2020,169,5,164,173.6
361,27/12/2020,307,2,305,187.8
362,28/12/2020,211,0,211,184.8
363,29/12/2020,101,0,101,181.4
364,30/12/2020,110,0,110,178.2
365,31/12/2020,142,1,141,173.6
366,01/01/2021,109,0,109,134.4
367,02/01/2021,4,1,3,92.8
368,03/01/2021,6,10,-4,71.8
369,04/01/2021,26,57,-31,43.6
370,05/01/2021,86,0,86,32.6
371,06/01/2021,788,176,612,133.2
372,07/01/2021,45,6,39,140.4
373,08/01/2021,61,49,12,143.6
374,09/01/2021,98,16,82,166.2
375,10/01/2021,24,2,22,153.4
376,11/01/2021,18,13,5,32
377,12/01/2021,43,57,-14,21.4
378,13/01/2021,110,33,77,34.4
379,14/01/2021,84,36,48,27.6
380,15/01/2021,74,22,52,33.6
381,16/01/2021,73,31,42,41
382,17/01/2021,61,26,35,50.8
383,18/01/2021,73,37,36,42.6
384,19/01/2021,98,35,63,45.6
385,20/01/2021,44,34,10,37.2
386,21/01/2021,108,59,49,38.6
387,22/01/2021,88,51,37,39
388,23/01/2021,73,59,14,34.6
389,24/01/2021,101,36,65,35
390,25/01/2021,147,38,109,54.8
391,26/01/2021,144,49,95,64
392,27/01/2021,214,46,168,90.2
393,28/01/2021,134,48,86,104.6
394,29/01/2021,4,68,-64,78.8
395,30/01/2021,6,14,-8,55.4
396,31/01/2021,3,17,-14,33.6
397,01/02/2021,36,17,19,3.8
398,02/02/2021,14,0,14,-10.6
399,03/02/2021,15,10,5,3.2
400,04/02/2021,27,56,-29,-1
401,05/02/2021,76,1,75,16.8
402,06/02/2021,842,196,646,142.2
403,07/02/2021,63,2,61,151.6
404,08/02/2021,83,3,80,166.6
405,09/02/2021,98,20,78,188
406,10/02/2021,14,2,12,175.4
407,11/02/2021,7,16,-9,44.4
408,12/02/2021,45,42,3,32.8
409,13/02/2021,8,33,-25,11.8
410,14/02/2021,33,57,-24,-8.6
411,15/02/2021,36,40,-4,-11.8
412,16/02/2021,37,25,12,-7.6
413,17/02/2021,40,32,8,-6.6
414,18/02/2021,37,32,5,-0.6
415,19/02/2021,15,28,-13,1.6
416,20/02/2021,8,4,4,3.2
417,21/02/2021,33,28,5,1.8
418,22/02/2021,34,47,-13,-2.4
419,23/02/2021,35,50,-15,-6.4
420,24/02/2021,34,49,-15,-6.8
421,25/02/2021,30,13,17,-4.2
422,26/02/2021,7,10,-3,-5.8
423,27/02/2021,7,4,3,-2.6
424,28/02/2021,15,11,4,1.2
425,01/03/2021,72,43,29,10
426,02/03/2021,15,3,12,9
427,03/03/2021,20,12,8,11.2
428,04/03/2021,27,46,-19,6.8
429,05/03/2021,88,0,88,23.6
430,06/03/2021,846,160,686,155
431,07/03/2021,103,0,103,173.2
432,08/03/2021,63,58,5,172.6
433,09/03/2021,68,10,58,188
434,10/03/2021,11,7,4,171.2
435,11/03/2021,19,13,6,35.2
436,12/03/2021,30,41,-11,12.4
437,13/03/2021,43,55,-12,9
438,14/03/2021,60,66,-6,-3.8
439,15/03/2021,71,78,-7,-6
440,16/03/2021,64,83,-19,-11
441,17/03/2021,66,117,-51,-19
442,18/03/2021,54,132,-78,-32.2
443,19/03/2021,35,120,-85,-48
444,20/03/2021,12,127,-115,-69.6
445,21/03/2021,27,137,-110,-87.8
446,22/03/2021,19,161,-142,-106
447,23/03/2021,18,156,-138,-118
448,24/03/2021,18,191,-173,-135.6
449,25/03/2021,1,183,-182,-149
450,26/03/2021,55,159,-104,-147.8
451,27/03/2021,45,148,-103,-140
452,28/03/2021,53,152,-99,-132.2
453,29/03/2021,30,187,-157,-129
454,30/03/2021,24,173,-149,-122.4
455,31/03/2021,25,188,-163,-134.2
456,01/04/2021,96,48,48,-104
457,02/04/2021,15,46,-31,-90.4
458,03/04/2021,49,11,38,-51.4
459,04/04/2021,35,5,30,-15.6
460,05/04/2021,85,1,84,33.8
461,06/04/2021,648,110,538,131.8
462,07/04/2021,114,0,114,160.8
463,08/04/2021,57,108,-51,143
464,09/04/2021,50,4,46,146.2
465,10/04/2021,20,6,14,132.2
466,11/04/2021,18,21,-3,24
467,12/04/2021,25,34,-9,-0.6
468,13/04/2021,70,1,69,23.4
469,14/04/2021,59,1,58,25.8
470,15/04/2021,79,3,76,38.2
471,16/04/2021,74,3,71,53
472,17/04/2021,73,0,73,69.4
473,18/04/2021,93,2,91,73.8
474,19/04/2021,125,0,125,87.2
475,20/04/2021,135,2,133,98.6
476,21/04/2021,130,1,129,110.2
477,22/04/2021,134,5,129,121.4
478,23/04/2021,159,1,158,134.8
479,24/04/2021,132,3,129,135.6
480,25/04/2021,125,1,124,133.8
481,26/04/2021,108,4,104,128.8
482,27/04/2021,98,2,96,122.2
483,28/04/2021,96,5,91,108.8
484,29/04/2021,102,4,98,102.6
485,30/04/2021,101,4,97,97.2
486,01/05/2021,86,55,31,82.6
487,02/05/2021,8,53,-45,54.4
488,03/05/2021,23,8,15,39.2
489,04/05/2021,93,1,92,38
490,05/05/2021,79,11,68,32.2
491,06/05/2021,610,98,512,128.4
492,07/05/2021,106,1,105,158.4
493,08/05/2021,73,130,-57,144
494,09/05/2021,72,12,60,137.6
495,10/05/2021,20,9,11,126.2
496,11/05/2021,18,17,1,24
497,12/05/2021,24,46,-22,-1.4
498,13/05/2021,77,16,61,22.2
499,14/05/2021,19,0,19,14
500,15/05/2021,24,1,23,16.4
501,16/05/2021,7,1,6,17.4
502,17/05/2021,5,1,4,22.6
503,18/05/2021,20,1,19,14.2
504,19/05/2021,43,0,43,19
505,20/05/2021,22,1,21,18.6
506,21/05/2021,27,1,26,22.6
507,22/05/2021,22,1,21,26
508,23/05/2021,39,1,38,29.8
509,24/05/2021,57,0,57,32.6
510,25/05/2021,62,1,61,40.6
511,26/05/2021,109,1,108,57
512,27/05/2021,174,0,174,87.6
513,28/05/2021,152,2,150,110
514,29/05/2021,83,1,82,115
515,30/05/2021,201,0,201,143
516,31/05/2021,306,1,305,182.4
517,01/06/2021,92,57,35,154.6
518,02/06/2021,8,57,-49,114.8
519,03/06/2021,11,3,8,100
520,04/06/2021,94,46,48,69.4
521,05/06/2021,78,11,67,21.8
522,06/06/2021,612,92,520,118.8
523,07/06/2021,124,3,121,152.8
524,08/06/2021,37,56,-19,147.4
525,09/06/2021,58,8,50,147.8
526,10/06/2021,20,9,11,136.6
527,11/06/2021,10,23,-13,30
528,12/06/2021,33,49,-16,2.6
529,13/06/2021,260,212,48,16
530,14/06/2021,236,220,16,9.2
531,15/06/2021,254,224,30,13
532,16/06/2021,220,220,0,15.6
533,17/06/2021,234,246,-12,16.4
534,18/06/2021,238,194,44,15.6
535,19/06/2021,234,172,62,24.8
536,20/06/2021,248,238,10,20.8
537,21/06/2021,300,252,48,30.4
538,22/06/2021,242,244,-2,32.4
539,23/06/2021,306,208,98,43.2
540,24/06/2021,224,160,64,43.6
541,25/06/2021,204,174,30,47.6
542,26/06/2021,168,124,44,46.8
543,27/06/2021,140,132,8,48.8
544,28/06/2021,108,158,-50,19.2
545,29/06/2021,112,166,-54,-4.4
546,30/06/2021,140,222,-82,-26.8
547,01/07/2021,38,56,-18,-39.2
548,02/07/2021,17,39,-22,-45.2
549,03/07/2021,24,63,-39,-43
550,04/07/2021,104,50,54,-21.4
551,05/07/2021,54,10,44,3.8
552,06/07/2021,340,176,164,40.2
553,07/07/2021,113,2,111,66.8
554,08/07/2021,29,2,27,80
555,09/07/2021,58,8,50,79.2
556,10/07/2021,19,9,10,72.4
557,11/07/2021,5,38,-33,33
558,12/07/2021,42,32,10,12.8
559,13/07/2021,138,1,137,34.8
560,14/07/2021,124,2,122,49.2
561,15/07/2021,105,2,103,67.8
562,16/07/2021,47,1,46,83.6
563,17/07/2021,95,1,94,100.4
564,18/07/2021,82,8,74,87.8
565,19/07/2021,157,3,154,94.2
566,20/07/2021,159,13,146,102.8
567,21/07/2021,118,7,111,115.8
568,22/07/2021,109,37,72,111.4
569,23/07/2021,76,61,15,99.6
570,24/07/2021,65,91,-26,63.6
571,25/07/2021,69,58,11,36.6
572,26/07/2021,94,49,45,23.4
573,27/07/2021,134,9,125,34
574,28/07/2021,112,19,93,49.6
575,29/07/2021,75,83,-8,53.2
576,30/07/2021,38,106,-68,37.4
577,31/07/2021,20,55,-35,21.4
578,01/08/2021,36,44,-8,-5.2
579,02/08/2021,15,66,-51,-34
580,03/08/2021,34,74,-40,-40.4
581,04/08/2021,68,51,17,-23.4
582,05/08/2021,57,14,43,-7.8
583,06/08/2021,294,182,112,16.2
584,07/08/2021,122,1,121,50.6
585,08/08/2021,57,7,50,68.6
586,09/08/2021,56,20,36,72.4
587,10/08/2021,24,3,21,68
588,11/08/2021,16,32,-16,42.4
589,12/08/2021,43,28,15,21.2
590,13/08/2021,40,46,-6,10
591,14/08/2021,22,77,-55,-8.2
592,15/08/2021,39,18,21,-8.2
593,16/08/2021,25,19,6,-3.8
594,17/08/2021,27,42,-15,-9.8
595,18/08/2021,46,17,29,-2.8
596,19/08/2021,32,59,-27,2.8
597,20/08/2021,15,86,-71,-15.6
598,21/08/2021,19,56,-37,-24.2
599,22/08/2021,31,65,-34,-28
600,23/08/2021,20,6,14,-31
601,24/08/2021,38,2,36,-18.4
602,25/08/2021,46,8,38,3.4
603,26/08/2021,51,5,46,20
604,27/08/2021,14,3,11,29
605,28/08/2021,12,0,12,28.6
606,29/08/2021,50,7,43,30
607,30/08/2021,70,15,55,33.4
608,31/08/2021,59,10,49,34
609,01/09/2021,38,38,0,31.8
610,02/09/2021,17,44,-27,24
611,03/09/2021,28,63,-35,8.4
612,04/09/2021,134,0,134,24.2
613,05/09/2021,65,15,50,24.4
614,06/09/2021,262,208,54,35.2
615,07/09/2021,140,1,139,68.4
616,08/09/2021,34,10,24,80.2
617,09/09/2021,88,98,-10,51.4
618,10/09/2021,19,3,16,44.6
619,11/09/2021,10,58,-48,24.2
620,12/09/2021,44,27,17,-0.2
621,13/09/2021,78,108,-30,-11
622,14/09/2021,80,104,-24,-13.8
623,15/09/2021,24,40,-16,-20.2
624,16/09/2021,24,22,2,-10.2
625,17/09/2021,22,62,-40,-21.6
626,18/09/2021,22,64,-42,-24
627,19/09/2021,32,100,-68,-32.8
628,20/09/2021,30,84,-54,-40.4
629,21/09/2021,26,66,-40,-48.8
630,22/09/2021,18,102,-84,-57.6
631,23/09/2021,40,90,-50,-59.2
632,24/09/2021,34,96,-62,-58
633,25/09/2021,34,98,-64,-60
634,26/09/2021,48,40,8,-50.4
635,27/09/2021,68,32,36,-26.4
636,28/09/2021,62,26,36,-9.2
637,29/09/2021,60,38,22,7.6
638,30/09/2021,48,32,16,23.6
639,01/10/2021,102,45,57,33.4
640,02/10/2021,15,43,-28,20.6
641,03/10/2021,33,72,-39,5.6
642,04/10/2021,135,1,134,28
643,05/10/2021,76,17,59,36.6
644,06/10/2021,252,204,48,34.8
645,07/10/2021,143,1,142,68.8
646,08/10/2021,47,14,33,83.2
647,09/10/2021,58,80,-22,52
648,10/10/2021,20,4,16,43.4
649,11/10/2021,10,64,-54,23
650,12/10/2021,28,17,11,-3.2
651,13/10/2021,27,47,-20,-13.8
652,14/10/2021,26,48,-22,-13.8
653,15/10/2021,21,43,-22,-21.4
654,16/10/2021,24,41,-17,-14
655,17/10/2021,11,45,-34,-23
656,18/10/2021,12,41,-29,-24.8
657,19/10/2021,25,43,-18,-24
658,20/10/2021,23,47,-24,-24.4
659,21/10/2021,15,5,10,-19
660,22/10/2021,21,3,18,-8.6
661,23/10/2021,21,3,18,0.8
662,24/10/2021,24,4,20,8.4
663,25/10/2021,24,7,17,16.6
664,26/10/2021,25,9,16,17.8
665,27/10/2021,16,6,10,16.2
666,28/10/2021,25,8,17,16
667,29/10/2021,11,9,2,12.4
668,30/10/2021,23,7,16,12.2
669,31/10/2021,13,2,11,11.2
670,01/11/2021,166,48,118,32.8
671,02/11/2021,23,54,-31,23.2
672,03/11/2021,53,78,-25,17.8
673,04/11/2021,133,0,133,41.2
674,05/11/2021,76,17,59,50.8
675,06/11/2021,252,152,100,47.2
676,07/11/2021,130,4,126,78.6
677,08/11/2021,36,5,31,89.8
678,09/11/2021,62,108,-46,54
679,10/11/2021,10,41,-31,36
680,11/11/2021,10,75,-65,3
681,12/11/2021,22,11,11,-20
682,13/11/2021,12,53,-41,-34.4
683,14/11/2021,13,37,-24,-30
684,15/11/2021,30,63,-33,-30.4
685,16/11/2021,27,65,-38,-25
686,17/11/2021,33,71,-38,-34.8
687,18/11/2021,21,62,-41,-34.8
688,19/11/2021,24,68,-44,-38.8
689,20/11/2021,27,66,-39,-40
690,21/11/2021,40,69,-29,-38.2
691,22/11/2021,31,61,-30,-36.6
692,23/11/2021,38,55,-17,-31.8
693,24/11/2021,45,60,-15,-26
694,25/11/2021,35,86,-51,-28.4
695,26/11/2021,18,60,-42,-31
696,27/11/2021,20,52,-32,-31.4
697,28/11/2021,37,64,-27,-33.4
698,29/11/2021,37,74,-37,-37.8
699,30/11/2021,32,79,-47,-37
700,01/12/2021,144,41,103,-8
701,02/12/2021,9,46,-37,-9
702,03/12/2021,55,66,-11,-5.8
703,04/12/2021,126,4,122,26
704,05/12/2021,79,16,63,48
705,06/12/2021,260,146,114,50.2
706,07/12/2021,147,2,145,86.6
707,08/12/2021,40,34,6,90
708,09/12/2021,140,130,10,67.6
709,10/12/2021,18,46,-28,49.4
710,11/12/2021,9,71,-62,14.2
711,12/12/2021,41,20,21,-10.6
712,13/12/2021,47,17,30,-5.8
713,14/12/2021,47,19,28,-2.2
714,15/12/2021,27,19,8,5
715,16/12/2021,52,20,32,23.8
716,17/12/2021,55,17,38,27.2
717,18/12/2021,49,13,36,28.4
718,19/12/2021,53,17,36,30
719,20/12/2021,54,20,34,35.2
720,21/12/2021,53,19,34,35.6
721,22/12/2021,88,43,45,37
722,23/12/2021,139,39,100,49.8
723,24/12/2021,117,25,92,61
724,25/12/2021,120,14,106,75.4
725,26/12/2021,157,14,143,97.2
726,27/12/2021,144,4,140,116.2
727,28/12/2021,119,4,115,119.2
728,29/12/2021,110,3,107,122.2
729,30/12/2021,99,7,92,119.4
730,31/12/2021,83,42,41,99
731,01/01/2022,57,37,20,75
732,02/01/2022,78,2,76,67.2
733,03/01/2022,9,30,-21,41.6
734,04/01/2022,41,79,-38,15.6
735,05/01/2022,117,15,102,27.8
736,06/01/2022,38,36,2,24.2
737,07/01/2022,37,10,27,14.4
738,08/01/2022,1,37,-36,11.4
739,09/01/2022,10,6,4,19.8
740,10/01/2022,17,3,14,2.2
741,11/01/2022,35,45,-10,-0.2
742,12/01/2022,101,157,-56,-16.8
743,13/01/2022,53,64,-11,-11.8
744,14/01/2022,51,54,-3,-13.2
745,15/01/2022,49,58,-9,-17.8
746,16/01/2022,46,67,-21,-20
747,17/01/2022,28,66,-38,-16.4
748,18/01/2022,19,71,-52,-24.6
749,19/01/2022,24,82,-58,-35.6
750,20/01/2022,20,74,-54,-44.6
751,21/01/2022,8,64,-56,-51.6
752,22/01/2022,10,58,-48,-53.6
753,23/01/2022,22,70,-48,-52.8
754,24/01/2022,24,66,-42,-49.6
755,25/01/2022,70,38,32,-32.4
756,26/01/2022,80,38,42,-12.8
757,27/01/2022,79,36,43,5.4
758,28/01/2022,73,29,44,23.8
759,29/01/2022,84,18,66,45.4
760,30/01/2022,80,18,62,51.4
761,31/01/2022,85,16,69,56.8
762,01/02/2022,26,56,-30,42.2
763,02/02/2022,72,0,72,47.8
764,03/02/2022,26,36,-10,32.6
765,04/02/2022,40,75,-35,13.2
766,05/02/2022,129,29,100,19.4
767,06/02/2022,46,26,20,29.4
768,07/02/2022,28,8,20,19
769,08/02/2022,1,47,-46,11.8
770,09/02/2022,15,2,13,21.4
771,10/02/2022,19,0,19,5.2
772,11/02/2022,40,70,-30,-4.8
773,12/02/2022,97,113,-16,-12
774,13/02/2022,28,43,-15,-5.8
775,14/02/2022,22,75,-53,-19
776,15/02/2022,30,74,-44,-31.6
777,16/02/2022,44,55,-11,-27.8
778,17/02/2022,41,63,-22,-29
779,18/02/2022,42,47,-5,-27
780,19/02/2022,17,44,-27,-21.8
781,20/02/2022,13,63,-50,-23
782,21/02/2022,12,57,-45,-29.8
783,22/02/2022,11,50,-39,-33.2
784,23/02/2022,15,41,-26,-37.4
785,24/02/2022,12,34,-22,-36.4
786,25/02/2022,18,41,-23,-31
787,26/02/2022,13,19,-6,-23.2
788,27/02/2022,15,18,-3,-16
789,28/02/2022,13,30,-17,-14.2
790,01/03/2022,23,74,-51,-20
791,02/03/2022,73,2,71,-1.2
792,03/03/2022,18,41,-23,-4.6
793,04/03/2022,52,98,-46,-13.2
794,05/03/2022,78,41,37,-2.4
795,06/03/2022,54,9,45,16.8
796,07/03/2022,23,12,11,4.8
797,08/03/2022,1,59,-58,-2.2
798,09/03/2022,8,0,8,8.6
799,10/03/2022,20,1,19,5
800,11/03/2022,47,68,-21,-8.2
801,12/03/2022,74,131,-57,-21.8
802,13/03/2022,104,41,63,2.4
803,14/03/2022,95,19,76,16
804,15/03/2022,110,16,94,31
805,16/03/2022,83,55,28,40.8
806,17/03/2022,90,17,73,66.8
807,18/03/2022,80,10,70,68.2
808,19/03/2022,62,9,53,63.6
809,20/03/2022,37,11,26,50
810,21/03/2022,79,7,72,58.8
811,22/03/2022,78,9,69,58
812,23/03/2022,59,10,49,53.8
813,24/03/2022,68,15,53,53.8
814,25/03/2022,69,19,50,58.6
815,26/03/2022,68,14,54,55
816,27/03/2022,72,57,15,44.2
817,28/03/2022,65,116,-51,24.2
818,29/03/2022,55,132,-77,-1.8
819,30/03/2022,53,120,-67,-25.2
820,31/03/2022,53,169,-116,-59.2
821,01/04/2022,40,39,1,-62
822,02/04/2022,73,0,73,-37.2
823,03/04/2022,21,23,-2,-22.2
824,04/04/2022,64,116,-52,-19.2
825,05/04/2022,39,18,21,8.2
826,06/04/2022,29,6,23,12.6
827,07/04/2022,27,12,15,1
828,08/04/2022,5,69,-64,-11.4
829,09/04/2022,16,6,10,1
830,10/04/2022,19,3,16,0
831,11/04/2022,32,67,-35,-11.6
832,12/04/2022,97,143,-46,-23.8
833,13/04/2022,123,77,46,-1.8
834,14/04/2022,131,80,51,6.4
835,15/04/2022,117,59,58,14.8
836,16/04/2022,108,38,70,35.8
837,17/04/2022,111,71,40,53
838,18/04/2022,110,71,39,51.6
839,19/04/2022,65,72,-7,40
840,20/04/2022,77,67,10,30.4
841,21/04/2022,89,10,79,32.2
842,22/04/2022,68,3,65,37.2
843,23/04/2022,50,3,47,38.8
844,24/04/2022,37,8,29,46
845,25/04/2022,54,12,42,52.4
846,26/04/2022,44,10,34,43.4
847,27/04/2022,24,10,14,33.2
848,28/04/2022,16,4,12,26.2
849,29/04/2022,97,15,82,36.8
850,30/04/2022,70,8,62,40.8
851,01/05/2022,73,48,25,39
852,02/05/2022,85,18,67,49.6
853,03/05/2022,11,9,2,47.6
854,04/05/2022,88,129,-41,23
855,05/05/2022,168,72,96,29.8
856,06/05/2022,19,8,11,27
857,07/05/2022,30,8,22,18
858,08/05/2022,8,54,-46,8.4
859,09/05/2022,16,7,9,18.4
860,10/05/2022,16,3,13,1.8
861,11/05/2022,45,68,-23,-5
862,12/05/2022,104,159,-55,-20.4
863,13/05/2022,37,112,-75,-26.2
864,14/05/2022,29,125,-96,-47.2
865,15/05/2022,42,115,-73,-64.4
866,16/05/2022,36,118,-82,-76.2
867,17/05/2022,41,128,-87,-82.6
868,18/05/2022,39,127,-88,-85.2
869,19/05/2022,35,120,-85,-83
870,20/05/2022,90,102,-12,-70.8
871,21/05/2022,82,117,-35,-61.4
872,22/05/2022,92,85,7,-42.6
873,23/05/2022,88,75,13,-22.4
874,24/05/2022,102,79,23,-0.8
875,25/05/2022,100,92,8,3.2
876,26/05/2022,102,96,6,11.4
877,27/05/2022,129,79,50,20
878,28/05/2022,114,110,4,18.2
879,29/05/2022,100,90,10,15.6
880,30/05/2022,53,98,-45,5
881,31/05/2022,39,91,-52,-6.6
882,01/06/2022,75,46,29,-10.8
883,02/06/2022,19,27,-8,-13.2
884,03/06/2022,25,36,-11,-17.4
885,04/06/2022,100,109,-9,-10.2
886,05/06/2022,120,55,65,13.2
887,06/06/2022,26,7,19,11.2
888,07/06/2022,29,9,20,16.8
889,08/06/2022,5,47,-42,10.6
890,09/06/2022,19,6,13,15
891,10/06/2022,16,9,7,3.4
892,11/06/2022,18,109,-91,-18.6
893,12/06/2022,97,113,-16,-25.8
894,13/06/2022,25,13,12,-15
895,14/06/2022,21,11,10,-15.6
896,15/06/2022,33,12,21,-12.8
897,16/06/2022,25,3,22,9.8
898,17/06/2022,33,2,31,19.2
899,18/06/2022,30,3,27,22.2
900,19/06/2022,11,3,8,21.8
901,20/06/2022,31,7,24,22.4
902,21/06/2022,22,13,9,19.8
903,22/06/2022,38,12,26,18.8
904,23/06/2022,35,8,27,18.8
905,24/06/2022,42,13,29,23
906,25/06/2022,30,14,16,21.4
907,26/06/2022,26,17,9,21.4
908,27/06/2022,10,9,1,16.4
909,28/06/2022,26,10,16,14.2
910,29/06/2022,30,13,17,11.8
911,30/06/2022,42,14,28,14.2
912,01/07/2022,70,52,18,16
913,02/07/2022,31,29,2,16.2
914,03/07/2022,25,30,-5,12
915,04/07/2022,97,103,-6,7.4
916,05/07/2022,118,62,56,13
917,06/07/2022,33,9,24,14.2
918,07/07/2022,17,7,10,15.8
919,08/07/2022,3,46,-43,8.2
920,09/07/2022,17,5,12,11.8
921,10/07/2022,16,3,13,3.2
922,11/07/2022,53,110,-57,-13
923,12/07/2022,127,87,40,-7
924,13/07/2022,18,8,10,3.6
925,14/07/2022,10,2,8,2.8
926,15/07/2022,14,1,13,2.8
927,16/07/2022,11,5,6,15.4
928,17/07/2022,14,5,9,9.2
929,18/07/2022,6,0,6,8.4
930,19/07/2022,12,0,12,9.2
931,20/07/2022,20,3,17,10
932,21/07/2022,15,3,12,11.2
933,22/07/2022,22,0,22,13.8
934,23/07/2022,16,3,13,15.2
935,24/07/2022,14,0,14,15.6
936,25/07/2022,10,0,10,14.2
937,26/07/2022,7,4,3,12.4
938,27/07/2022,12,1,11,10.2
939,28/07/2022,13,3,10,9.6
940,29/07/2022,7,0,7,8.2
941,30/07/2022,11,3,8,7.8
942,31/07/2022,5,3,2,7.6
943,01/08/2022,65,43,22,9.8
944,02/08/2022,23,26,-3,7.2
945,03/08/2022,41,32,9,7.6
946,04/08/2022,59,92,-33,-0.6
947,05/08/2022,100,89,11,1.2
948,06/08/2022,19,9,10,-1.2
949,07/08/2022,25,6,19,3.2
950,08/08/2022,6,74,-68,-12.2
951,09/08/2022,20,10,10,-3.6
952,10/08/2022,5,0,5,-4.8
953,11/08/2022,70,75,-5,-7.8
954,12/08/2022,131,81,50,-1.6
955,13/08/2022,14,64,-50,2
956,14/08/2022,12,92,-80,-16
957,15/08/2022,16,75,-59,-28.8
958,16/08/2022,18,83,-65,-40.8
959,17/08/2022,25,93,-68,-64.4
960,18/08/2022,32,99,-67,-67.8
961,19/08/2022,28,69,-41,-60
962,20/08/2022,31,72,-41,-56.4
963,21/08/2022,17,76,-59,-55.2
964,22/08/2022,19,78,-59,-53.4
965,23/08/2022,13,74,-61,-52.2
966,24/08/2022,16,74,-58,-55.6
967,25/08/2022,15,81,-66,-60.6
968,26/08/2022,12,63,-51,-59
969,27/08/2022,14,72,-58,-58.8
970,28/08/2022,11,60,-49,-56.4
971,29/08/2022,8,29,-21,-49
972,30/08/2022,11,22,-11,-38
973,31/08/2022,12,11,1,-27.6
974,01/09/2022,64,39,25,-11
975,02/09/2022,28,39,-11,-3.4
976,03/09/2022,49,40,9,2.6
977,04/09/2022,42,80,-38,-2.8
978,05/09/2022,83,79,4,-2.2
979,06/09/2022,27,9,18,-3.6
980,07/09/2022,23,5,18,2.2
981,08/09/2022,5,77,-72,-14
982,09/09/2022,23,4,19,-2.6
983,10/09/2022,7,0,7,-2
984,11/09/2022,76,96,-20,-9.6
985,12/09/2022,68,75,-7,-14.6
986,13/09/2022,53,5,48,9.4
987,14/09/2022,50,6,44,14.4
988,15/09/2022,62,11,51,23.2
989,16/09/2022,37,1,36,34.4
990,17/09/2022,58,3,55,46.8
991,18/09/2022,45,3,42,45.6
992,19/09/2022,39,8,31,43
993,20/09/2022,39,4,35,39.8
994,21/09/2022,44,4,40,40.6
995,22/09/2022,44,8,36,36.8
996,23/09/2022,17,1,16,31.6
997,24/09/2022,20,3,17,28.8
998,25/09/2022,33,3,30,27.8
999,26/09/2022,34,0,34,26.6
1000,27/09/2022,28,0,28,25
1001,28/09/2022,34,3,31,28
1002,29/09/2022,40,8,32,31
1003,30/09/2022,25,3,22,29.4
1004,01/10/2022,51,49,2,23
1005,02/10/2022,30,40,-10,15.4
1006,03/10/2022,74,30,44,18
1007,04/10/2022,103,90,13,14.2
1008,05/10/2022,92,87,5,10.8
1009,06/10/2022,33,13,20,14.4
1010,07/10/2022,8,9,-1,16.2
1011,08/10/2022,7,81,-74,-7.4
1012,09/10/2022,27,4,23,-5.4
1013,10/10/2022,6,0,6,-5.2
1014,11/10/2022,70,72,-2,-9.6
1015,12/10/2022,58,111,-53,-20
1016,13/10/2022,6,3,3,-4.6
1017,14/10/2022,7,3,4,-8.4
1018,15/10/2022,8,3,5,-8.6
1019,16/10/2022,6,3,3,-7.6
1020,17/10/2022,6,3,3,3.6
1021,18/10/2022,8,0,8,4.6
1022,19/10/2022,14,3,11,6
1023,20/10/2022,20,0,20,9
1024,21/10/2022,20,3,17,11.8
1025,22/10/2022,10,0,10,13.2
1026,23/10/2022,7,5,2,12
1027,24/10/2022,10,7,3,10.4
1028,25/10/2022,9,5,4,7.2
1029,26/10/2022,8,10,-2,3.4
1030,27/10/2022,12,13,-1,1.2
1031,28/10/2022,18,11,7,2.2
1032,29/10/2022,18,9,9,3.4
1033,30/10/2022,29,11,18,6.2
1034,31/10/2022,31,13,18,10.2
1035,01/11/2022,54,51,3,11
1036,02/11/2022,37,25,12,12
1037,03/11/2022,68,72,-4,9.4
1038,04/11/2022,116,78,38,13.4
1039,05/11/2022,59,102,-43,1.2
1040,06/11/2022,20,8,12,3
1041,07/11/2022,10,3,7,2
1042,08/11/2022,19,67,-48,-6.8
1043,09/11/2022,40,5,35,-7.4
1044,10/11/2022,18,0,18,4.8
1045,11/11/2022,64,54,10,4.4
1046,12/11/2022,85,131,-46,-6.2
1047,13/11/2022,54,79,-25,-1.6
1048,14/11/2022,32,42,-10,-10.6
1049,15/11/2022,42,83,-41,-22.4
1050,16/11/2022,59,113,-54,-35.2
1051,17/11/2022,64,64,0,-26
1052,18/11/2022,79,97,-18,-24.6
1053,19/11/2022,88,88,0,-22.6
1054,20/11/2022,98,101,-3,-15
1055,21/11/2022,100,67,33,2.4
1056,22/11/2022,86,75,11,4.6
1057,23/11/2022,80,44,36,15.4
1058,24/11/2022,47,70,-23,10.8
1059,25/11/2022,34,78,-44,2.6
1060,26/11/2022,29,74,-45,-13
1061,27/11/2022,45,129,-84,-32
1062,28/11/2022,53,125,-72,-53.6
1063,29/11/2022,42,121,-79,-64.8
1064,30/11/2022,51,156,-105,-77
1065,01/12/2022,55,62,-7,-69.4
1066,02/12/2022,40,21,19,-48.8
1067,03/12/2022,61,12,49,-24.6
1068,04/12/2022,128,78,50,1.2
1069,05/12/2022,45,101,-56,11
1070,06/12/2022,7,7,0,12.4
1071,07/12/2022,15,7,8,10.2
1072,08/12/2022,12,65,-53,-10.2
1073,09/12/2022,61,9,52,-9.8
1074,10/12/2022,6,3,3,2
1075,11/12/2022,59,62,-3,1.4
1076,12/12/2022,86,118,-32,-6.6
1077,13/12/2022,63,124,-61,-8.2
1078,14/12/2022,70,126,-56,-29.8
1079,15/12/2022,73,107,-34,-37.2
1080,16/12/2022,54,27,27,-31.2
1081,17/12/2022,36,14,22,-20.4
1082,18/12/2022,20,13,7,-6.8
1083,19/12/2022,21,12,9,6.2
1084,20/12/2022,20,12,8,14.6
1085,21/12/2022,20,12,8,10.8
1086,22/12/2022,19,27,-8,4.8
1087,23/12/2022,38,23,15,6.4
1088,24/12/2022,42,20,22,9
1089,25/12/2022,37,23,14,10.2
1090,26/12/2022,40,25,15,11.6
1091,27/12/2022,41,42,-1,13
1092,28/12/2022,16,50,-34,3.2
1093,29/12/2022,22,39,-17,-4.6
1094,30/12/2022,20,41,-21,-11.6
1095,31/12/2022,23,39,-16,-17.8
1096,01/01/2023,9,49,-40,-25.6
1097,02/01/2023,126,0,126,6.4
1098,03/01/2023,46,37,9,11.6
1099,04/01/2023,70,30,40,23.8
1100,05/01/2023,24,4,20,31
1101,06/01/2023,11,5,6,40.2
1102,07/01/2023,108,6,102,35.4
1103,08/01/2023,136,11,125,58.6
1104,09/01/2023,8,4,4,51.4
1105,10/01/2023,60,5,55,58.4
1106,11/01/2023,2,0,2,57.6
1107,12/01/2023,0,4,-4,36.4
1108,13/01/2023,20,16,4,12.2
1109,14/01/2023,23,9,14,14.2
1110,15/01/2023,22,15,7,4.6
1111,16/01/2023,22,16,6,5.4
1112,17/01/2023,22,13,9,8
1113,18/01/2023,22,10,12,9.6
1114,19/01/2023,24,11,13,9.4
1115,20/01/2023,21,10,11,10.2
1116,21/01/2023,15,11,4,9.8
1117,22/01/2023,12,12,0,8
1118,23/01/2023,12,9,3,6.2
1119,24/01/2023,12,14,-2,3.2
1120,25/01/2023,12,8,4,1.8
1121,26/01/2023,22,14,8,2.6
1122,27/01/2023,30,11,19,6.4
1123,28/01/2023,39,7,32,12.2
1124,29/01/2023,31,11,20,16.6
1125,30/01/2023,51,0,51,26
1126,31/01/2023,99,3,96,43.6
1127,01/02/2023,15,50,-35,32.8
1128,02/02/2023,63,0,63,39
1129,03/02/2023,45,28,17,38.4
1130,04/02/2023,88,47,41,36.4
1131,05/02/2023,28,7,21,21.4
1132,06/02/2023,23,2,21,32.6
1133,07/02/2023,169,24,145,49
1134,08/02/2023,123,11,112,68
1135,09/02/2023,8,1,7,61.2
1136,10/02/2023,58,11,47,66.4
1137,11/02/2023,3,2,1,62.4
1138,12/02/2023,0,4,-4,32.6
1139,13/02/2023,19,4,15,13.2
1140,14/02/2023,26,1,25,16.8
1141,15/02/2023,42,0,42,15.8
1142,16/02/2023,35,7,28,21.2
1143,17/02/2023,36,0,36,29.2
1144,18/02/2023,48,19,29,32
1145,19/02/2023,87,38,49,36.8
1146,20/02/2023,117,53,64,41.2
1147,21/02/2023,82,43,39,43.4
1148,22/02/2023,116,38,78,51.8
1149,23/02/2023,108,46,62,58.4
1150,24/02/2023,72,47,25,53.6
1151,25/02/2023,52,36,16,44
1152,26/02/2023,104,38,66,49.4
1153,27/02/2023,112,53,59,45.6
1154,28/02/2023,69,45,24,38
1155,01/03/2023,24,53,-29,27.2
1156,02/03/2023,40,4,36,31.2
1157,03/03/2023,44,15,29,23.8
1158,04/03/2023,76,55,21,16.2
1159,05/03/2023,30,21,9,13.2
1160,06/03/2023,15,2,13,21.6
1161,07/03/2023,126,39,87,31.8
1162,08/03/2023,104,2,102,46.4
1163,09/03/2023,22,13,9,44
1164,10/03/2023,57,14,43,50.8
1165,11/03/2023,2,0,2,48.6
1166,12/03/2023,0,0,0,31.2
1167,13/03/2023,52,29,23,15.4
1168,14/03/2023,48,32,16,16.8
1169,15/03/2023,34,28,6,9.4
1170,16/03/2023,31,69,-38,1.4
1171,17/03/2023,27,58,-31,-4.8
1172,18/03/2023,21,38,-17,-12.8
1173,19/03/2023,32,60,-28,-21.6
1174,20/03/2023,45,68,-23,-27.4
1175,21/03/2023,57,102,-45,-28.8
1176,22/03/2023,64,124,-60,-34.6
1177,23/03/2023,49,106,-57,-42.6
1178,24/03/2023,39,92,-53,-47.6
1179,25/03/2023,39,63,-24,-47.8
1180,26/03/2023,35,84,-49,-48.6
1181,27/03/2023,58,86,-28,-42.2
1182,28/03/2023,62,94,-32,-37.2
1183,29/03/2023,62,100,-38,-34.2
1184,30/03/2023,68,64,4,-28.6
1185,31/03/2023,54,52,2,-18.4
1186,01/04/2023,19,51,-32,-19.2
1187,02/04/2023,44,0,44,-4
1188,03/04/2023,32,12,20,7.6
1189,04/04/2023,86,54,32,13.2
1190,05/04/2023,25,50,-25,7.8
1191,06/04/2023,21,13,8,15.8
1192,07/04/2023,134,46,88,24.6
1193,08/04/2023,87,5,82,37
1194,09/04/2023,20,11,9,32.4
1195,10/04/2023,94,15,79,53.2
1196,11/04/2023,2,0,2,52
1197,12/04/2023,0,0,0,34.4
1198,13/04/2023,74,83,-9,16.2
1199,14/04/2023,56,80,-24,9.6
1200,15/04/2023,29,73,-44,-15
1201,16/04/2023,48,73,-25,-20.4
1202,17/04/2023,54,74,-20,-24.4
1203,18/04/2023,5,47,-42,-31
1204,19/04/2023,46,87,-41,-34.4
1205,20/04/2023,44,80,-36,-32.8
1206,21/04/2023,18,43,-25,-32.8
1207,22/04/2023,23,41,-18,-32.4
1208,23/04/2023,39,43,-4,-24.8
1209,24/04/2023,21,21,0,-16.6
1210,25/04/2023,13,9,4,-8.6
1211,26/04/2023,31,32,-1,-3.8
1212,27/04/2023,27,4,23,4.4
1213,28/04/2023,28,3,25,10.2
1214,29/04/2023,25,10,15,13.2
1215,30/04/2023,26,5,21,16.6
1216,01/05/2023,16,46,-30,10.8
1217,02/05/2023,36,2,34,13
1218,03/05/2023,30,10,20,12
1219,04/05/2023,85,36,49,18.8
1220,05/05/2023,22,34,-12,12.2
1221,06/05/2023,26,12,14,21
1222,07/05/2023,140,39,101,34.4
1223,08/05/2023,81,1,80,46.4
1224,09/05/2023,32,10,22,41
1225,10/05/2023,21,7,14,46.2
1226,11/05/2023,2,0,2,43.8
1227,12/05/2023,0,0,0,23.6
1228,13/05/2023,14,14,0,7.6
1229,14/05/2023,22,30,-8,1.6
1230,15/05/2023,29,32,-3,-1.8
1231,16/05/2023,18,11,7,-0.8
1232,17/05/2023,21,11,10,1.2
1233,18/05/2023,23,6,17,4.6
1234,19/05/2023,20,6,14,9
1235,20/05/2023,20,6,14,12.4
1236,21/05/2023,28,2,26,16.2
1237,22/05/2023,21,3,18,17.8
1238,23/05/2023,34,2,32,20.8
1239,24/05/2023,41,6,35,25
1240,25/05/2023,4,6,-2,21.8
1241,26/05/2023,0,2,-2,16.2
1242,27/05/2023,4,5,-1,12.4
1243,28/05/2023,3,0,3,6.6
1244,29/05/2023,2,3,-1,-0.6
1245,30/05/2023,12,0,12,2.2
1246,31/05/2023,7,2,5,3.6
1247,01/06/2023,37,43,-6,2.6
1248,02/06/2023,49,3,46,11.2
1249,03/06/2023,58,24,34,18.2
1250,04/06/2023,75,35,40,23.8
1251,05/06/2023,11,36,-25,17.8
1252,06/06/2023,29,15,14,21.8
1253,07/06/2023,83,42,41,20.8
1254,08/06/2023,93,5,88,31.6
1255,09/06/2023,35,10,25,28.6
1256,10/06/2023,7,7,0,33.6
1257,11/06/2023,2,3,-1,30.6
1258,12/06/2023,0,2,-2,22
1259,13/06/2023,98,1,97,23.8
1260,14/06/2023,132,3,129,44.6
1261,15/06/2023,184,4,180,80.6
1262,16/06/2023,131,2,129,106.6
1263,17/06/2023,108,3,105,128
1264,18/06/2023,216,3,213,151.2
1265,19/06/2023,202,4,198,165
1266,20/06/2023,176,13,163,161.6
1267,21/06/2023,205,26,179,171.6
1268,22/06/2023,198,28,170,184.6
1269,23/06/2023,86,31,55,153
1270,24/06/2023,62,27,35,120.4
1271,25/06/2023,160,27,133,114.4
1272,26/06/2023,149,27,122,103
1273,27/06/2023,163,32,131,95.2
1274,28/06/2023,169,14,155,115.2
1275,29/06/2023,154,9,145,137.2
1276,30/06/2023,90,5,85,127.6
1277,01/07/2023,37,44,-7,101.8
1278,02/07/2023,41,0,41,83.8
1279,03/07/2023,42,31,11,55
1280,04/07/2023,70,33,37,33.4
1281,05/07/2023,6,49,-43,7.8
1282,06/07/2023,41,12,29,15
1283,07/07/2023,44,42,2,7.2
1284,08/07/2023,101,3,98,24.6
1285,09/07/2023,33,22,11,19.4
1286,10/07/2023,2,4,-2,27.6
1287,11/07/2023,2,1,1,22
1288,12/07/2023,0,1,-1,21.4
1289,13/07/2023,62,29,33,8.4
1290,14/07/2023,30,17,13,8.8
1291,15/07/2023,22,10,12,11.6
1292,16/07/2023,61,21,40,19.4
1293,17/07/2023,54,9,45,28.6
1294,18/07/2023,56,24,32,28.4
1295,19/07/2023,47,10,37,33.2
1296,20/07/2023,58,29,29,36.6
1297,21/07/2023,38,13,25,33.6
1298,22/07/2023,28,8,20,28.6
1299,23/07/2023,62,30,32,28.6
1300,24/07/2023,111,8,103,41.8
1301,25/07/2023,99,24,75,51
1302,26/07/2023,80,22,58,57.6
1303,27/07/2023,53,11,42,62
1304,28/07/2023,71,4,67,69
1305,29/07/2023,70,2,68,62
1306,30/07/2023,151,2,149,76.8
1307,31/07/2023,147,10,137,92.6
1308,01/08/2023,38,49,-11,82
1309,02/08/2023,42,5,37,76
1310,03/08/2023,36,31,5,63.4
1311,04/08/2023,79,24,55,44.6
1312,05/08/2023,0,30,-30,11.2
1313,06/08/2023,87,12,75,28.4
1314,07/08/2023,31,41,-10,19
1315,08/08/2023,125,5,120,42
1316,09/08/2023,13,16,-3,30.4
1317,10/08/2023,6,1,5,37.4
1318,11/08/2023,3,0,3,23
1319,12/08/2023,0,2,-2,24.6
1320,13/08/2023,85,1,84,17.4
1321,14/08/2023,161,2,159,49.8
1322,15/08/2023,211,1,210,90.8
1323,16/08/2023,243,6,237,137.6
1324,17/08/2023,326,1,325,203
1325,18/08/2023,273,2,271,240.4
1326,19/08/2023,162,2,160,240.6
1327,20/08/2023,338,3,335,265.6
1328,21/08/2023,282,2,280,274.2
1329,22/08/2023,244,2,242,257.6
1330,23/08/2023,214,1,213,246
1331,24/08/2023,147,3,144,242.8
1332,25/08/2023,49,1,48,185.4
1333,26/08/2023,44,0,44,138.2
1334,27/08/2023,60,2,58,101.4
1335,28/08/2023,52,3,49,68.6
1336,29/08/2023,43,2,41,48
1337,30/08/2023,34,1,33,45
1338,31/08/2023,18,5,13,38.8
1339,01/09/2023,35,14,21,31.4
1340,02/09/2023,34,0,34,28.4
1341,03/09/2023,48,38,10,22.2
1342,04/09/2023,89,41,48,25.2
1343,05/09/2023,2,47,-45,13.6
1344,06/09/2023,94,15,79,25.2
1345,07/09/2023,46,39,7,19.8
1346,08/09/2023,105,3,102,38.2
1347,09/09/2023,20,14,6,29.8
1348,10/09/2023,9,1,8,40.4
1349,11/09/2023,2,1,1,24.8
1350,12/09/2023,1,1,0,23.4
1351,13/09/2023,27,10,17,6.4
1352,14/09/2023,31,13,18,8.8
1353,15/09/2023,8,13,-5,6.2
1354,16/09/2023,4,13,-9,4.2
1355,17/09/2023,14,16,-2,3.8
1356,18/09/2023,13,16,-3,-0.2
1357,19/09/2023,14,17,-3,-4.4
1358,20/09/2023,11,26,-15,-6.4
1359,21/09/2023,13,26,-13,-7.2
1360,22/09/2023,0,13,-13,-9.4
1361,23/09/2023,1,10,-9,-10.6
1362,24/09/2023,4,11,-7,-11.4
1363,25/09/2023,0,7,-7,-9.8
1364,26/09/2023,11,12,-1,-7.4
1365,27/09/2023,17,23,-6,-6
1366,28/09/2023,17,19,-2,-4.6
1367,29/09/2023,4,13,-9,-5
1368,30/09/2023,2,9,-7,-5
1369,01/10/2023,13,16,-3,-5.4
1370,02/10/2023,21,1,20,-0.2
1371,03/10/2023,26,22,4,1
1372,04/10/2023,90,82,8,4.4
1373,05/10/2023,14,25,-11,3.6
1374,06/10/2023,86,11,75,19.2
1375,07/10/2023,42,39,3,15.8
1376,08/10/2023,110,5,105,36
1377,09/10/2023,40,10,30,40.4
1378,10/10/2023,12,0,12,45
1379,11/10/2023,2,0,2,30.4
1380,12/10/2023,0,0,0,29.8
1381,13/10/2023,0,3,-3,8.2
1382,14/10/2023,0,0,0,2.2
1383,15/10/2023,0,0,0,-0.2
1384,16/10/2023,1,0,1,-0.4
1385,17/10/2023,0,0,0,-0.4
1386,18/10/2023,0,3,-3,-0.4
1387,19/10/2023,0,1,-1,-0.6
1388,20/10/2023,0,1,-1,-0.8
1389,21/10/2023,0,3,-3,-1.6
1390,22/10/2023,0,0,0,-1.6
1391,23/10/2023,0,3,-3,-1.6
1392,24/10/2023,0,0,0,-1.4
1393,25/10/2023,0,0,0,-1.2
1394,26/10/2023,0,1,-1,-0.8
1395,27/10/2023,0,4,-4,-1.6
1396,28/10/2023,0,0,0,-1
1397,29/10/2023,0,3,-3,-1.6
1398,30/10/2023,0,0,0,-1.6
1399,31/10/2023,0,3,-3,-2
1400,01/11/2023,14,17,-3,-1.8
1401,02/11/2023,21,4,17,1.6
1402,03/11/2023,19,12,7,3.6
1403,04/11/2023,66,49,17,7
1404,05/11/2023,21,4,17,11
1405,06/11/2023,114,1,113,34.2
1406,07/11/2023,48,30,18,34.4
1407,08/11/2023,86,1,85,50
1408,09/11/2023,28,12,16,49.8
1409,10/11/2023,0,0,0,46.4
1410,11/11/2023,2,0,2,24.2
1411,12/11/2023,0,4,-4,19.8
1412,13/11/2023,2,3,-1,2.6
1413,14/11/2023,2,6,-4,-1.4
1414,15/11/2023,2,16,-14,-4.2
1415,16/11/2023,2,22,-20,-8.6
1416,17/11/2023,2,27,-25,-12.8
1417,18/11/2023,2,28,-26,-17.8
1418,19/11/2023,2,27,-25,-22
1419,20/11/2023,2,27,-25,-24.2
1420,21/11/2023,2,25,-23,-24.8
1421,22/11/2023,2,25,-23,-24.4
1422,23/11/2023,2,17,-15,-22.2
1423,24/11/2023,4,4,0,-17.2
1424,25/11/2023,2,3,-1,-12.4
1425,26/11/2023,2,5,-3,-8.4
1426,27/11/2023,3,4,-1,-4
1427,28/11/2023,2,1,1,-0.8
1428,29/11/2023,4,3,1,-0.6
1429,30/11/2023,3,2,1,-0.2
1430,01/12/2023,21,11,10,2.4
1431,02/12/2023,19,0,19,6.4
1432,03/12/2023,79,31,48,15.8
1433,04/12/2023,74,42,32,22
1434,05/12/2023,28,10,18,25.4
1435,06/12/2023,93,3,90,41.4
1436,07/12/2023,68,22,46,46.8
1437,08/12/2023,50,4,46,46.4
1438,09/12/2023,30,14,16,43.2
1439,10/12/2023,0,0,0,39.6
1440,11/12/2023,3,3,0,21.6
1441,12/12/2023,0,0,0,12.4
1442,13/12/2023,0,0,0,3.2
1443,14/12/2023,0,0,0,0
1444,15/12/2023,0,1,-1,-0.2
1445,16/12/2023,1,0,1,0
1446,17/12/2023,0,1,-1,-0.2
1447,18/12/2023,0,3,-3,-0.8
1448,19/12/2023,0,1,-1,-1
1449,20/12/2023,0,1,-1,-1
1450,21/12/2023,0,3,-3,-1.8
1451,22/12/2023,0,1,-1,-1.8
1452,23/12/2023,1,3,-2,-1.6
1453,24/12/2023,0,1,-1,-1.6
1454,25/12/2023,0,5,-5,-2.4
1455,26/12/2023,0,1,-1,-2
1456,27/12/2023,0,0,0,-1.8
1457,28/12/2023,0,2,-2,-1.8
1458,29/12/2023,0,1,-1,-1.8
1459,30/12/2023,0,3,-3,-1.4
1460,31/12/2023,1,1,0,-1.2
1461,01/01/2024,0,0,0,-1.2
1462,02/01/2024,10,62,-52,-11.2
1463,03/01/2024,16,10,6,-9.8
1464,04/01/2024,49,46,3,-8.6
1465,05/01/2024,14,0,14,-5.8
1466,06/01/2024,34,22,12,-3.4
1467,07/01/2024,176,32,144,35.8
1468,08/01/2024,640,30,610,156.6
1469,09/01/2024,71,0,71,170.2
1470,10/01/2024,20,2,18,171
1471,11/01/2024,1,6,-5,167.6
1472,12/01/2024,112,0,112,161.2
1473,13/01/2024,1,3,-2,38.8
1474,14/01/2024,1,1,0,24.6
1475,15/01/2024,0,0,0,21
1476,16/01/2024,0,0,0,22
1477,17/01/2024,0,1,-1,-0.6
1478,18/01/2024,1,2,-1,-0.4
1479,19/01/2024,0,0,0,-0.4
1480,20/01/2024,0,1,-1,-0.6
1481,21/01/2024,0,2,-2,-1
1482,22/01/2024,1,4,-3,-1.4
1483,23/01/2024,3,0,3,-0.6
1484,24/01/2024,6,0,6,0.6
1485,25/01/2024,0,2,-2,0.4
1486,26/01/2024,2,1,1,1
1487,27/01/2024,6,1,5,2.6
1488,28/01/2024,3,2,1,2.2
1489,29/01/2024,4,3,1,1.2
1490,30/01/2024,5,3,2,2
1491,31/01/2024,6,1,5,2.8
1492,01/02/2024,1,4,-3,1.2
1493,02/02/2024,6,0,6,2.2
1494,03/02/2024,10,2,8,3.6
1495,04/02/2024,6,55,-49,-6.6
1496,05/02/2024,6,0,6,-6.4
1497,06/02/2024,62,14,48,3.8
1498,07/02/2024,188,34,154,33.4
1499,08/02/2024,0,0,0,31.8
1500,09/02/2024,59,1,58,53.2
1501,10/02/2024,19,4,15,55
1502,11/02/2024,9,7,2,45.8
1503,12/02/2024,97,0,97,34.4
1504,13/02/2024,8,38,-30,28.4
1505,14/02/2024,8,6,2,17.2
1506,15/02/2024,2,22,-20,10.2
1507,16/02/2024,2,2,0,9.8
1508,17/02/2024,10,6,4,-8.8
1509,18/02/2024,8,2,6,-1.6
1510,19/02/2024,10,0,10,0
1511,20/02/2024,6,6,0,4
1512,21/02/2024,10,0,10,6
1513,22/02/2024,6,18,-12,2.8
1514,23/02/2024,6,0,6,2.8
1515,24/02/2024,12,6,6,2
1516,25/02/2024,10,6,4,2.8
1517,26/02/2024,14,0,14,3.6
1518,27/02/2024,6,0,6,7.2
1519,28/02/2024,18,10,8,7.6
1520,29/02/2024,2,6,-4,5.6
1521,01/03/2024,0,0,0,4.8
1522,02/03/2024,8,8,0,2
1523,03/03/2024,44,8,36,8
1524,04/03/2024,9,39,-30,0.4
1525,05/03/2024,16,2,14,4
1526,06/03/2024,36,40,-4,3.2
1527,07/03/2024,182,32,150,33.2
1528,08/03/2024,0,0,0,26
1529,09/03/2024,57,4,53,42.6
1530,10/03/2024,4,0,4,40.6
1531,11/03/2024,5,6,-1,41.2
1532,12/03/2024,95,0,95,30.2
1533,13/03/2024,296,0,296,89.4
1534,14/03/2024,310,22,288,136.4
1535,15/03/2024,220,12,208,177.2
1536,16/03/2024,222,2,220,221.4
1537,17/03/2024,306,8,298,262
1538,18/03/2024,330,22,308,264.4
1539,19/03/2024,328,12,316,270
1540,20/03/2024,332,22,310,290.4
1541,21/03/2024,164,38,126,271.6
1542,22/03/2024,56,28,28,217.6
1543,23/03/2024,28,18,10,158
1544,24/03/2024,174,30,144,123.6
1545,25/03/2024,132,38,94,80.4
1546,26/03/2024,126,56,70,69.2
1547,27/03/2024,110,46,64,76.4
1548,28/03/2024,124,46,78,90
1549,29/03/2024,80,40,40,69.2
1550,30/03/2024,108,48,60,62.4
1551,31/03/2024,112,74,38,56
1552,01/04/2024,0,0,0,43.2
1553,02/04/2024,14,42,-28,22
1554,03/04/2024,46,2,44,22.8
1555,04/04/2024,22,42,-20,6.8
1556,05/04/2024,6,0,6,0.4
1557,06/04/2024,58,26,32,6.8
1558,07/04/2024,166,42,124,37.2
1559,08/04/2024,0,0,0,28.4
1560,09/04/2024,34,3,31,38.6
1561,10/04/2024,2,0,2,37.8
1562,11/04/2024,3,6,-3,30.8
1563,12/04/2024,96,0,96,25.2
1564,13/04/2024,27,40,-13,22.6
1565,14/04/2024,82,69,13,19
1566,15/04/2024,85,65,20,22.6
1567,16/04/2024,68,64,4,24
1568,17/04/2024,96,68,28,10.4
1569,18/04/2024,73,63,10,15
1570,19/04/2024,67,50,17,15.8
1571,20/04/2024,56,10,46,21
1572,21/04/2024,69,38,31,26.4
1573,22/04/2024,51,18,33,27.4
1574,23/04/2024,56,8,48,35
1575,24/04/2024,21,17,4,32.4
1576,25/04/2024,26,21,5,24.2
1577,26/04/2024,33,13,20,22
1578,27/04/2024,40,9,31,21.6
1579,28/04/2024,6,16,-10,10
1580,29/04/2024,15,4,11,11.4
1581,30/04/2024,8,6,2,10.8
1582,01/05/2024,0,3,-3,6.2
1583,02/05/2024,138,46,92,18.4
1584,03/05/2024,64,2,62,32.8
1585,04/05/2024,26,28,-2,30.2
1586,05/05/2024,16,2,14,32.6
1587,06/05/2024,48,24,24,38
1588,07/05/2024,244,34,210,61.6
1589,08/05/2024,0,0,0,49.2
1590,09/05/2024,41,11,30,55.6
1591,10/05/2024,2,0,2,53.2
1592,11/05/2024,32,6,26,53.6
1593,12/05/2024,99,1,98,31.2
1594,13/05/2024,4,18,-14,28.4
1595,14/05/2024,20,72,-52,12
1596,15/05/2024,6,30,-24,6.8
1597,16/05/2024,18,52,-34,-5.2
1598,17/05/2024,4,60,-56,-36
1599,18/05/2024,22,68,-46,-42.4
1600,19/05/2024,6,38,-32,-38.4
1601,20/05/2024,22,36,-14,-36.4
1602,21/05/2024,10,64,-54,-40.4
1603,22/05/2024,28,52,-24,-34
1604,23/05/2024,8,50,-42,-33.2
1605,24/05/2024,24,32,-8,-28.4
1606,25/05/2024,28,46,-18,-29.2
1607,26/05/2024,10,38,-28,-24
1608,27/05/2024,16,44,-28,-24.8
1609,28/05/2024,8,50,-42,-24.8
1610,29/05/2024,24,54,-30,-29.2
1611,30/05/2024,10,56,-46,-34.8
1612,31/05/2024,36,20,16,-26
1613,01/06/2024,0,0,0,-20.4
1614,02/06/2024,156,38,118,11.6
1615,03/06/2024,44,2,42,26
1616,04/06/2024,26,14,12,37.6
1617,05/06/2024,6,12,-6,33.2
1618,06/06/2024,62,44,18,36.8
1619,07/06/2024,164,34,130,39.2
1620,08/06/2024,0,0,0,30.8
1621,09/06/2024,34,0,34,35.2
1622,10/06/2024,2,0,2,36.8
1623,11/06/2024,20,6,14,36
1624,12/06/2024,43,0,43,18.6
1625,13/06/2024,66,20,46,27.8
1626,14/06/2024,148,28,120,45
1627,15/06/2024,150,30,120,68.6
1628,16/06/2024,236,24,212,108.2
1629,17/06/2024,318,14,304,160.4
1630,18/06/2024,402,24,378,226.8
1631,19/06/2024,370,30,340,270.8
1632,20/06/2024,214,18,196,286
1633,21/06/2024,214,32,182,280
1634,22/06/2024,214,38,176,254.4
1635,23/06/2024,230,38,192,217.2
1636,24/06/2024,252,36,216,192.4
1637,25/06/2024,282,54,228,198.8
1638,26/06/2024,246,34,212,204.8
1639,27/06/2024,206,38,168,203.2
1640,28/06/2024,164,32,132,191.2
1641,29/06/2024,180,28,152,178.4
1642,30/06/2024,148,38,110,154.8
1643,01/07/2024,0,0,0,112.4
1644,02/07/2024,160,44,116,102
1645,03/07/2024,80,14,66,88.8
1646,04/07/2024,37,15,22,62.8
1647,05/07/2024,18,26,-8,39.2
1648,06/07/2024,40,16,24,44
1649,07/07/2024,284,34,250,70.8
1650,08/07/2024,0,0,0,57.6
1651,09/07/2024,42,3,39,61
1652,10/07/2024,0,0,0,62.6
1653,11/07/2024,24,6,18,61.4
1654,12/07/2024,20,0,20,15.4
1655,13/07/2024,148,46,102,35.8
1656,14/07/2024,180,38,142,56.4
1657,15/07/2024,182,40,142,84.8
1658,16/07/2024,144,36,108,102.8
1659,17/07/2024,172,66,106,120
1660,18/07/2024,156,96,60,111.6
1661,19/07/2024,112,62,50,93.2
1662,20/07/2024,60,42,18,68.4
1663,21/07/2024,108,86,22,51.2
1664,22/07/2024,120,86,34,36.8
1665,23/07/2024,144,66,78,40.4
1666,24/07/2024,164,106,58,42
1667,25/07/2024,254,106,148,68
1668,26/07/2024,262,94,168,97.2
1669,27/07/2024,154,78,76,105.6
1670,28/07/2024,158,100,58,101.6
1671,29/07/2024,202,76,126,115.2
1672,30/07/2024,268,72,196,124.8
1673,31/07/2024,582,60,522,195.6
1674,01/08/2024,0,0,0,180.4
1675,02/08/2024,156,38,118,192.4
1676,03/08/2024,36,0,36,174.4
1677,04/08/2024,49,35,14,138
1678,05/08/2024,28,42,-14,30.8
1679,06/08/2024,70,18,52,41.2
1680,07/08/2024,296,36,260,69.6
1681,08/08/2024,0,0,0,62.4
1682,09/08/2024,18,0,18,63.2
1683,10/08/2024,10,1,9,67.8
1684,11/08/2024,19,7,12,59.8
1685,12/08/2024,40,0,40,15.8
1686,13/08/2024,0,0,0,15.8
1687,14/08/2024,0,0,0,12.2
1688,15/08/2024,0,0,0,10.4
1689,16/08/2024,0,0,0,8
1690,17/08/2024,0,0,0,0
1691,18/08/2024,0,0,0,0
1692,19/08/2024,0,0,0,0
1693,20/08/2024,0,0,0,0
1694,21/08/2024,0,0,0,0
1695,22/08/2024,0,0,0,0
1696,23/08/2024,0,0,0,0
1697,24/08/2024,0,0,0,0
1698,25/08/2024,0,0,0,0
1699,26/08/2024,0,0,0,0
1700,27/08/2024,0,0,0,0
1701,28/08/2024,0,0,0,0
1702,29/08/2024,0,0,0,0
1703,30/08/2024,0,0,0,0
1704,31/08/2024,0,0,0,0
1705,01/09/2024,0,2,-2,-0.4
1706,02/09/2024,142,8,134,26.4
1707,03/09/2024,30,2,28,32
1708,04/09/2024,50,35,15,35
1709,05/09/2024,8,44,-36,27.8
1710,06/09/2024,42,50,-8,26.6
1711,07/09/2024,304,46,258,51.4
1712,08/09/2024,0,0,0,45.8
1713,09/09/2024,16,2,14,45.6
1714,10/09/2024,0,1,-1,52.6
1715,11/09/2024,24,6,18,57.8
1716,12/09/2024,19,0,19,10
1717,13/09/2024,40,2,38,17.6
1718,14/09/2024,28,4,24,19.6
1719,15/09/2024,26,4,22,24.2
1720,16/09/2024,13,2,11,22.8
1721,17/09/2024,20,5,15,22
1722,18/09/2024,9,5,4,15.2
1723,19/09/2024,16,13,3,11
1724,20/09/2024,22,3,19,10.4
1725,21/09/2024,14,4,10,10.2
1726,22/09/2024,8,4,4,8
1727,23/09/2024,15,4,11,9.4
1728,24/09/2024,14,3,11,11
1729,25/09/2024,11,0,11,9.4
1730,26/09/2024,9,9,0,7.4
1731,27/09/2024,16,0,16,9.8
1732,28/09/2024,28,2,26,12.8
1733,29/09/2024,27,1,26,15.8
1734,30/09/2024,21,0,21,17.8
1735,01/10/2024,0,1,-1,17.6
1736,02/10/2024,154,6,148,44
1737,03/10/2024,86,0,86,56
1738,04/10/2024,73,41,32,57.2
1739,05/10/2024,16,64,-48,43.4
1740,06/10/2024,50,38,12,46
1741,07/10/2024,294,56,238,64
1742,08/10/2024,0,0,0,46.8
1743,09/10/2024,34,2,32,46.8
1744,10/10/2024,8,1,7,57.8
1745,11/10/2024,20,6,14,58.2
1746,12/10/2024,21,0,21,14.8
1747,13/10/2024,4,2,2,15.2
1748,14/10/2024,0,4,-4,8
1749,15/10/2024,6,3,3,7.2
1750,16/10/2024,2,0,2,4.8
1751,17/10/2024,8,0,8,2.2
1752,18/10/2024,10,0,10,3.8
1753,19/10/2024,0,1,-1,4.4
1754,20/10/2024,8,0,8,5.4
1755,21/10/2024,0,1,-1,4.8
1756,22/10/2024,8,0,8,4.8
1757,23/10/2024,1,0,1,3
1758,24/10/2024,9,0,9,5
1759,25/10/2024,7,0,7,4.8
1760,26/10/2024,0,1,-1,4.8
1761,27/10/2024,7,0,7,4.6
1762,28/10/2024,0,0,0,4.4
1763,29/10/2024,8,1,7,4
1764,30/10/2024,0,0,0,2.6
1765,31/10/2024,8,3,5,3.8
1766,01/11/2024,0,3,-3,1.8
1767,02/11/2024,132,40,92,20.2
1768,03/11/2024,216,0,216,62
1769,04/11/2024,85,71,14,64.8
1770,05/11/2024,6,62,-56,52.6
1771,06/11/2024,48,44,4,54
1772,07/11/2024,262,50,212,78
1773,08/11/2024,0,0,0,34.8
1774,09/11/2024,16,1,15,35
1775,10/11/2024,0,0,0,46.2
1776,11/11/2024,26,6,20,49.4
1777,12/11/2024,9,1,8,8.6
1778,13/11/2024,24,6,18,12.2
1779,14/11/2024,29,8,21,13.4
1780,15/11/2024,24,3,21,17.6
1781,16/11/2024,46,7,39,21.4
1782,17/11/2024,85,19,66,33
1783,18/11/2024,73,18,55,40.4
1784,19/11/2024,65,13,52,46.6
1785,20/11/2024,65,19,46,51.6
1786,21/11/2024,74,21,53,54.4
1787,22/11/2024,52,19,33,47.8
1788,23/11/2024,65,10,55,47.8
1789,24/11/2024,158,6,152,67.8
1790,25/11/2024,152,9,143,87.2
1791,26/11/2024,131,3,128,102.2
1792,27/11/2024,133,3,130,121.6
1793,28/11/2024,131,4,127,136
1794,29/11/2024,90,3,87,123
1795,30/11/2024,95,4,91,112.6
1796,01/12/2024,0,4,-4,86.2
1797,02/12/2024,14,40,-26,55
1798,03/12/2024,284,0,284,86.4
1799,04/12/2024,43,57,-14,66.2
1800,05/12/2024,4,28,-24,43.2
1801,06/12/2024,70,22,48,53.6
1802,07/12/2024,162,32,130,84.8
1803,08/12/2024,0,0,0,28
1804,09/12/2024,36,5,31,37
1805,10/12/2024,0,0,0,41.8
1806,11/12/2024,26,6,20,36.2
1807,12/12/2024,12,1,11,12.4
1808,13/12/2024,8,1,7,13.8
1809,14/12/2024,15,1,14,10.4
1810,15/12/2024,11,1,10,12.4
1811,16/12/2024,14,0,14,11.2
1812,17/12/2024,14,2,12,11.4
1813,18/12/2024,22,0,22,14.4
1814,19/12/2024,37,2,35,18.6
1815,20/12/2024,36,1,35,23.6
1816,21/12/2024,32,0,32,27.2
1817,22/12/2024,30,1,29,30.6
1818,23/12/2024,26,3,23,30.8
1819,24/12/2024,26,6,20,27.8
1820,25/12/2024,121,4,117,44.2
1821,26/12/2024,180,3,177,73.2
1822,27/12/2024,123,1,122,91.8
1823,28/12/2024,121,0,121,111.4
1824,29/12/2024,159,0,159,139.2
1825,30/12/2024,167,2,165,148.8
1826,31/12/2024,188,0,188,151
